NIVEL 1

    #####
####---#
#----x-#
####---#
    #####

P: 1,2
C: 6,2 5,3




FINAL NIVEL 1